Data,Description ,Credit,Debit,Balance
05-12-2024,Salary,100000,0,120000
05-12-2024,Amazon,0,2000,118000
10-12-2024,ATM withdrawal,0,5000,113000
15-12-2024,Freelance,25000,0,138000
20-12-2024,Electricity bill,0,1500,136500
25-12-2024,received from friend,5000,0,141500
